1111111111111111111111111111111111111111
1E0000000000000C00000C000000000000000001
1010010100100000101001000000010100000001
1010010010101010001001000000010100000001
1P0000000C00C0000000000000000000C0000001
1000001000000100000100000000001000001001
1000000000000000010000000000100000000001
10000010000C00001C000000000010110000C001
1000000000000C00010000000000000000110001
1111111111111111111111111111111111111111