111111111
1E0001P11
100C0010
1E0000001
111101111