111111111
100000001
1P00P00C1
1000C00E1
111111111